1,1,1,1,1,1,1,1,1,1,1,1,1,1,1,1
1,1,1,1,1,1,1,1,1,1,1,1,1,1,1,1
1,1,1,10,5,5,5,5,5,9,1,1,1,1,1,1
1,1,1,6,4,4,4,4,4,8,1,1,1,1,1,1
1,1,1,6,4,4,4,4,4,8,1,1,1,1,1,1
1,1,1,6,4,4,4,4,4,8,1,1,1,1,1,1
1,1,1,11,7,7,7,7,7,12,1,1,1,1,1,1
