1,1,1,1,1,1,1,1,1,20,20,20,20,20,20,1,1,1,1,1
1,1,1,1,1,1,1,1,1,20,20,20,20,20,20,1,1,1,1,1
1,1,1,10,5,5,5,9,1,21,21,21,21,21,21,1,1,1,1,1
1,1,1,6,4,4,4,8,1,15,17,13,17,17,16,1,1,1,1,1
1,1,1,6,4,4,4,8,1,15,17,14,17,18,16,1,1,1,1,1
1,1,1,6,4,4,4,8,1,1,1,1,1,1,1,1,1,1,1,1
1,1,1,11,7,7,7,12,1,1,1,1,1,1,1,1,1,1,1,1
1,1,1,1,1,1,1,1,1,1,1,1,1,1,1,1,1,1,1,1
1,1,1,1,1,1,1,1,1,1,1,1,1,1,1,1,1,1,1,1
1,1,1,1,1,1,1,1,1,1,1,1,1,1,1,1,1,1,1,1
1,1,1,1,1,1,1,1,1,1,1,1,1,35,35,35,35,1,1,1
1,1,1,1,1,1,1,1,1,1,1,1,1,35,35,35,35,1,1,1
1,1,1,1,1,1,1,1,1,1,1,1,1,35,35,35,35,1,1,1
1,1,1,1,1,1,1,1,1,1,1,1,1,1,1,1,1,1,1,1
1,1,1,1,1,1,1,1,1,1,1,1,1,1,1,1,1,1,1,1
1,1,1,1,1,1,1,1,1,1,1,1,1,1,1,1,1,1,1,1
1,1,1,1,1,1,1,1,1,1,1,1,1,1,1,1,1,1,1,1
1,1,1,1,1,1,1,1,1,1,1,1,1,1,1,1,1,1,1,1
